?PWSandbox-Map 1.0;

(map: begin)
@@@@@@@@@@@@@@@@@@@@@@@@@@@@@@@@
@=                             @
@@@@@@@@@@@@@@@@@@@@@@@        @
@                              @
@        @@@@@@@@@@@@@@@@@@@@@@@
@                              @
@@@@@@@@@@@@@@@@@@@@@@@        @
@                              @
@        @@@@@@@@@@@@@@@@@@@@@@@
@     !                        @
@@@@@@@@@@@@@@@@@@@@@@@@@@@@@@@@
(map: end)
