?PWSandbox-Map 1.1;

(map: begin)
@@@@@@@@@@@@@@@@@@@@
@=################=@
@@@@@##@@##@@##@@@@@
@    **      **    @
@               @@@@
@               @
@               @@@@
@@@@               @
   @               @
@@@@               @
@                  @@@@@
@        !            .
@                 @@@@
@                 @
@@@@@@@@@@@@@@@@@@@
(map: end)
